1111111
1P100E1
1010111
1C10C01
1010111
1C10001
1011101
1000C01
1111111