1111111111
1000000001
1000000001
1CP0000E01
1111111111