11111111111
1000C000001
10P00C00EC1
10000000001
11111111111

10110100011
10110111101
11000100001
11110101111
11110110001
11111111111