11111111111
10000000001
10P00C00E01
100000000011
111111111111