11111111111
10000000001
10P00C00E00
10000000001
11111111111