111111111111
10001000E001
10C01PC00011
100010000111
111111111111