11111111111
10000000001
100E0P0C001
10000000001
11111111111