1111111
1P10C01
1010E01
1C10001
1010001
1C10C01
1010C01
1000001
1111111