11111111111
10000000001
10P00C00011
10000000111
11111111111