111111111111111
10P00C010111111
100000010E11111
111111111011111
111111011111111
111111111111111
