11111111111
10000000001
10P00C00E01
100000000E1
11111111111